(supertux-level
  (version 3)
  (name (_ "No Turning Back"))
  (author "FrostC, Tylerandari12")
  (license "CC-BY-SA 4.0 International")
  (icon "")
  (icon-locked "")
  (sector
    (name "main")
    (init-script "import(\"res/industrial/scripts/cutscenes/no_turning_back.nut\")

init_cutscene()")
    (ambient-light
      (color 0.6 0.6 0.6)
    )
    (background
      (scroll-offset-y 80)
      (color 0.8 0.8 0.8)
      (speed 0)
      (image-top "/images/background/misc/transparent_up.png")
      (image "/images/background/forest/forest_panorama.png")
    )
    (background
      (scroll-offset-x 1)
      (color 0.4 0.5 0.4)
      (scroll-speed-x 4)
      (speed 0)
      (image "/images/background/misc/skybox.png")
      (z-pos -303)
    )
    (background
      (scroll-offset-x 2864)
      (scroll-offset-y 1360)
      (color 1 1 1 0.6)
      (speed 1)
      (image "/images/background/misc/fog.png")
      (z-pos 120)
    )
    (background
      (color 1 1 1)
      (speed 0.2)
      (image-top "/images/background/misc/transparent_up.png")
      (image "/images/background/forest/tree_back.png")
      (image-bottom "/images/background/forest/forest_bottom.png")
      (z-pos -285)
    )
    (background
      (color 0.8 0.8 0.8)
      (speed 0.5)
      (image "/images/background/forest_cave/cave_forest.png")
      (image-bottom "/images/background/forest_cave/cave_forest.png")
      (z-pos -280)
    )
    (background
      (color 1 1 1)
      (speed 0.35)
      (image-top "/images/background/misc/transparent_up.png")
      (image "/images/background/forest/tree_front.png")
      (z-pos -283)
    )
    (background
      (color 1 1 1)
      (speed 0)
      (fill #t)
      (image "/images/background/misc/vignette.png")
      (z-pos 300)
    )
    (camera
      (name "Camera")
      (mode "normal")
    )
    (gradient
      (top_color 0.2 0.2 0.2)
      (bottom_color 0.6 0.6 0.9)
      (z-pos -400)
    )
    (invisible_wall
      (width 96)
      (height 32)
      (x -80)
      (y 832)
    )
    (music
      (file "/res/industrial/mus/cutscene/Another_repurposed_rodirod_song.music")
    )
    (spawnpoint
      (name "main")
      (x 0)
      (y 768)
    )
    (spawnpoint
      (name "cam1")
      (x 720)
      (y 688)
    )
    (spawnpoint
      (name "pos1")
      (x 864)
      (y 688)
    )
    (spawnpoint
      (name "pos2")
      (x 800)
      (y 688)
    )
    (spawnpoint
      (name "pos3")
      (x 352)
      (y 688)
    )
    (spawnpoint
      (name "pos4")
      (x 1072)
      (y 688)
    )
    (tilemap
      (solid #t)
      (z-pos -15)
      (name "RoddyroddDuud")
      (width 40)
      (height 40)
      (tiles
      0 0 0 0 0 0 0 0 0 0 0 0 0 0 0 0 0 0 0 0 0 0 0 0 0 0 0 0 0 0 0 0 0 0 0 0 0 0 0 0
      0 0 0 0 0 0 0 0 0 0 0 0 0 0 0 0 0 0 0 0 0 0 0 0 0 0 0 0 0 0 0 0 0 0 0 0 0 0 0 0
      0 0 0 0 0 0 0 0 0 0 0 0 0 0 0 0 0 0 0 0 0 0 0 0 0 0 0 0 0 0 0 0 0 0 0 0 0 0 0 0
      0 0 0 0 0 0 0 0 0 0 0 0 0 0 0 0 0 0 0 0 0 0 0 0 0 0 0 0 0 0 0 0 0 0 0 0 0 0 0 0
      0 0 0 0 0 0 0 0 0 0 0 0 0 0 0 0 0 0 0 0 0 0 0 0 0 0 0 0 0 0 0 0 0 0 0 0 0 0 0 0
      0 0 0 0 0 0 0 0 0 0 0 0 0 0 0 0 0 0 0 0 0 0 0 0 0 0 0 0 0 0 0 0 0 0 0 0 0 0 0 0
      0 0 0 0 0 0 0 0 0 0 0 0 0 0 0 0 0 0 0 0 0 0 0 0 0 0 0 0 0 0 0 0 0 0 0 0 0 0 0 0
      0 0 0 0 0 0 0 0 0 0 0 0 0 0 0 0 0 0 0 0 0 0 0 0 0 0 0 0 0 0 0 0 0 0 0 0 0 0 0 0
      0 0 0 0 0 0 0 0 0 0 0 0 0 0 0 0 0 0 0 0 0 0 0 0 0 0 0 0 0 0 0 0 0 0 0 0 0 0 0 0
      0 0 0 0 0 0 0 0 0 0 0 0 0 0 0 0 0 0 0 0 0 0 0 0 0 0 0 0 0 0 0 0 0 0 0 0 0 0 0 0
      0 0 0 0 0 0 0 0 0 0 0 0 0 0 0 0 0 0 0 0 0 0 0 0 0 0 0 0 0 0 0 0 0 0 0 0 0 0 0 0
      0 0 0 0 0 0 0 0 0 0 0 0 0 0 0 0 0 0 0 0 0 0 0 0 0 0 0 0 0 0 0 0 0 0 0 0 0 0 0 0
      0 0 0 0 0 0 0 0 0 0 0 0 0 0 0 0 0 0 0 0 0 0 0 0 0 0 0 0 0 0 0 0 0 0 0 0 0 0 0 0
      0 0 0 0 0 0 0 0 0 0 0 0 0 0 0 0 0 0 0 0 0 0 0 0 0 0 0 0 0 0 0 0 0 0 0 0 0 0 0 0
      0 0 0 0 0 0 0 0 0 0 0 0 0 0 0 0 0 0 0 0 0 0 0 0 0 0 0 0 0 0 0 0 0 0 0 0 0 0 0 0
      0 0 0 0 0 0 0 0 0 0 0 0 0 0 0 0 0 0 0 0 0 0 0 0 0 0 0 0 0 0 0 0 0 0 0 0 0 0 0 0
      0 0 0 0 0 0 0 0 0 0 0 0 0 0 0 0 0 0 0 0 0 0 0 0 0 0 0 0 0 0 0 0 0 0 0 0 0 0 0 0
      0 0 0 0 0 0 0 0 0 0 0 0 0 0 0 0 0 0 0 0 0 0 0 0 0 0 0 0 0 0 0 0 0 0 0 0 0 0 0 0
      0 0 0 0 0 0 0 0 0 0 0 0 0 0 0 0 0 0 0 0 0 0 0 0 0 0 0 0 0 0 0 0 0 0 0 0 323 324 0 0
      0 0 0 0 0 0 0 0 0 0 0 0 0 0 0 0 0 0 0 0 0 0 0 0 0 0 0 0 0 0 0 0 0 0 0 0 325 326 0 0
      0 0 0 0 0 0 0 0 0 0 323 324 0 0 0 0 0 0 0 0 0 0 0 0 0 0 0 0 0 0 0 0 0 0 0 0 327 328 0 0
      0 0 0 0 0 0 0 0 0 0 325 326 0 0 0 0 0 0 0 0 0 0 0 0 0 0 0 0 0 0 0 0 0 0 0 0 329 330 0 0
      0 0 0 0 0 0 0 0 0 0 327 328 0 0 0 0 0 0 0 0 0 0 0 0 0 0 0 0 0 0 0 0 0 0 0 0 0 0 0 0
      0 0 0 0 0 0 0 0 0 0 329 330 0 0 0 0 0 0 2518 4153 4154 4155 0 0 0 0 0 0 0 0 0 0 0 0 0 0 0 360 2516 2517
      0 0 0 0 0 0 0 0 0 0 0 0 0 0 0 0 0 0 2529 2530 2531 2532 0 0 322 0 0 0 0 0 0 0 0 0 0 0 0 0 0 0
      0 0 2516 2517 0 0 0 0 0 0 0 0 0 0 0 0 0 0 0 0 0 0 0 0 0 0 0 0 0 0 2631 0 0 0 0 0 0 0 0 0
      0 0 0 0 0 0 0 0 0 6609 0 0 0 0 0 0 0 0 0 0 0 0 0 0 0 0 0 0 0 0 0 0 0 0 0 0 0 0 0 0
      0 0 0 0 0 0 0 0 0 0 0 0 0 0 0 0 0 0 0 0 0 0 0 0 0 0 0 0 0 0 0 0 0 0 0 0 0 0 0 0
      0 0 0 0 0 0 0 0 0 0 0 0 0 0 0 0 0 0 0 0 0 0 0 0 0 0 0 0 0 0 0 0 0 0 0 0 0 0 0 0
      0 0 0 0 0 0 0 0 0 0 0 0 0 0 0 0 0 0 0 0 0 0 0 0 0 0 0 0 0 0 0 0 0 0 0 0 0 0 0 0
      0 0 0 0 0 0 0 0 0 0 0 0 0 0 0 0 0 0 0 0 0 0 0 0 0 0 0 0 0 0 0 0 0 0 0 0 0 0 0 0
      0 0 0 0 0 0 0 0 0 0 0 0 0 0 0 0 0 0 0 0 0 0 0 0 0 0 0 0 0 0 0 0 0 0 0 0 0 0 0 0
      0 0 0 0 0 0 0 0 0 0 0 0 0 0 0 0 0 0 0 0 0 0 0 0 0 0 0 0 0 0 0 0 0 0 0 0 0 0 0 0
      0 0 0 0 0 0 0 0 0 0 0 0 0 0 0 0 0 0 0 0 0 0 0 0 0 0 0 0 0 0 0 0 0 0 0 0 0 0 0 0
      0 0 0 0 0 0 0 0 0 0 0 0 0 0 0 0 0 0 0 0 0 0 0 0 0 0 0 0 0 0 0 0 0 0 0 0 0 0 0 0
      0 0 0 0 0 0 0 0 0 0 0 0 0 0 0 0 0 0 0 0 0 0 0 0 0 0 0 0 0 0 0 0 0 0 0 0 0 0 0 0
      0 0 0 0 0 0 0 0 0 0 0 0 0 0 0 0 0 0 0 0 0 0 0 0 0 0 0 0 0 0 0 0 0 0 0 0 0 0 0 0
      0 0 0 0 0 0 0 0 0 0 0 0 0 0 0 0 0 0 0 0 0 0 0 0 0 0 0 0 0 0 0 0 0 0 0 0 0 0 0 0
      0 0 0 0 0 0 0 0 0 0 0 0 0 0 0 0 0 0 0 0 0 0 0 0 0 0 0 0 0 0 0 0 0 0 0 0 0 0 0 0
      0 0 0 0 0 0 0 0 0 0 0 0 0 0 0 0 0 0 0 0 0 0 0 0 0 0 0 0 0 0 0 0 0 0 0 0 0 0 0 0
      )
    )
    (tilemap
      (solid #f)
      (z-pos -50)
      (width 40)
      (height 40)
      (tiles
      0 0 0 0 0 0 0 0 0 0 0 0 0 0 0 0 0 0 0 0 0 0 0 0 0 0 0 0 0 0 0 0 0 0 0 0 0 0 0 0
      0 0 0 0 0 0 0 0 0 0 0 0 0 0 0 0 0 0 0 0 0 0 0 0 0 0 0 0 0 0 0 0 0 0 0 0 0 0 0 0
      0 0 0 0 0 0 0 0 0 0 0 0 0 0 0 0 0 0 0 0 0 0 0 0 0 0 0 0 0 0 0 0 0 0 0 0 0 0 0 0
      0 0 0 0 0 0 0 0 0 0 0 0 0 0 0 0 0 0 0 0 0 0 0 0 0 0 0 0 0 0 0 0 0 0 0 0 0 0 0 0
      0 0 0 0 0 0 0 0 0 0 0 0 0 0 0 0 0 0 0 0 0 0 0 0 0 0 0 0 0 0 0 0 0 0 0 0 0 0 0 0
      0 0 0 0 0 0 0 0 0 0 0 0 0 0 0 0 0 0 0 0 0 0 0 0 0 0 0 0 0 0 0 0 0 0 0 0 0 0 0 0
      0 0 0 0 0 0 0 0 0 0 0 0 0 0 0 0 0 0 0 0 0 0 0 0 0 0 0 0 0 0 0 0 0 0 0 0 0 0 0 0
      0 0 0 0 0 0 0 0 0 0 0 0 0 0 0 0 0 0 0 0 0 0 0 0 0 0 0 0 0 0 0 0 0 0 0 0 0 0 0 0
      0 0 0 0 0 0 0 0 0 0 0 0 0 0 0 0 0 0 0 0 0 0 0 0 0 0 0 0 0 0 0 0 0 0 0 0 0 0 0 0
      0 0 0 0 0 0 0 0 0 0 0 0 0 0 0 0 0 0 0 0 0 0 0 0 0 0 0 0 0 0 0 5644 5689 5646 0 0 0 0 0 0
      0 0 0 0 0 0 0 0 0 0 0 0 0 0 0 0 5645 5689 5646 0 0 0 0 0 0 5645 5646 0 0 0 0 5667 5668 5688 5646 0 0 0 5645 5646
      0 0 0 0 0 0 0 0 0 0 0 0 0 0 0 0 5679 5665 5677 0 0 0 0 0 0 5679 5688 5646 0 0 0 5667 5679 5676 5677 0 0 0 5679 5688
      0 0 0 0 0 0 0 0 0 0 0 0 0 0 5645 5689 5690 5663 5677 0 0 0 0 0 0 5643 5668 5688 5689 5646 0 5643 5643 5668 5688 5646 5645 5689 5681 5668
      0 0 0 0 0 0 0 0 0 0 0 0 0 5645 5690 5675 5663 5666 5644 0 0 0 0 0 0 0 5679 5663 5686 5688 5646 0 0 5679 5664 5688 5690 5666 5644 5679
      0 0 0 0 0 0 0 0 0 0 0 0 0 5643 5668 5663 5685 5677 0 0 0 0 0 0 0 0 5643 5668 5687 5686 5688 5646 0 5643 5668 5665 5664 5677 0 5643
      0 0 0 0 0 0 0 0 0 0 0 0 0 0 5668 5685 5666 5644 0 0 0 0 0 0 0 0 0 5679 5665 5674 5674 5677 0 0 5679 5663 5674 5677 0 0
      0 0 0 0 0 0 0 0 0 0 0 0 5645 5689 5690 5674 5677 0 0 0 0 0 0 0 0 0 0 5679 5686 5665 5685 5688 5689 5689 5690 5664 5687 5677 0 0
      0 0 0 0 0 5645 5646 0 0 5645 5646 0 5679 5687 5674 5665 5677 0 0 0 0 0 0 0 0 0 0 5643 5668 5674 5663 5685 5663 5665 5675 5676 5685 5677 0 0
      0 0 0 0 5645 5690 5677 5645 5689 5690 5677 0 5643 5667 5668 5674 5677 0 0 0 0 0 0 0 0 0 0 0 5679 5686 5666 5667 5668 5664 5685 5666 5668 5677 5645 5646
      0 0 0 5645 5690 5665 5688 5690 5665 5665 5688 5689 5646 0 5643 5668 5677 0 0 0 0 0 0 0 0 0 0 0 5679 5665 5677 0 5679 5665 5665 5688 5690 5688 5690 5688
      0 5645 5689 5690 5665 5665 5675 5663 5687 5666 5668 5666 5644 0 0 5679 5677 0 0 0 0 0 0 0 0 0 0 0 5679 5663 5677 0 5643 5668 5663 5674 5666 5668 5674 5686
      5689 5690 5676 5664 5663 5666 5668 5674 5675 5688 5690 5677 0 0 0 5679 5688 5646 0 0 0 0 0 0 0 0 0 0 5679 5666 5644 0 0 5643 5668 5666 5644 5679 5666 5668
      5663 5674 5663 5687 5666 5644 5643 5667 5668 5686 5666 5644 0 0 0 5679 5674 5677 0 0 0 0 0 0 0 0 0 0 5679 5688 5646 0 0 5645 5690 5677 0 5679 5677 5643
      5663 5676 5675 5675 5677 0 0 0 5679 5686 5688 5646 0 0 5645 5690 5665 5688 5646 0 0 0 0 0 0 0 0 5645 5690 5686 5677 0 0 5679 5663 5688 5646 5679 5677 0
      5663 5687 5687 5664 5688 5646 0 5645 5681 5668 5674 5677 0 0 5679 5687 5665 5665 5677 0 0 0 0 0 0 5645 5689 5690 5687 5675 5677 5645 5689 5690 5686 5687 5688 5690 5677 0
      5664 5664 5674 5687 5676 5688 5689 5690 5688 5690 5686 5688 5646 0 5679 5685 5675 5686 5688 5646 0 0 0 0 0 5679 5663 5665 5675 5674 5688 5690 5666 5667 5687 5675 5666 5667 5644 0
      5668 5675 5687 5666 5667 5668 5665 5664 5675 5664 5666 5668 5688 5689 5690 5666 5667 5667 5667 5644 0 0 0 0 0 5643 5667 5667 5667 5667 5667 5667 5644 0 5665 5666 5644 0 0 0
      5643 5667 5667 5644 0 5643 5667 5667 5668 5674 5677 5679 5687 5666 5666 5644 0 0 0 0 0 0 0 0 0 0 0 0 0 0 0 0 0 5667 5687 5677 0 0 0 0
      0 0 0 0 0 0 0 0 5643 5668 5688 5681 5667 5680 5677 0 0 0 0 0 0 0 0 0 0 0 0 0 0 0 0 0 0 5643 5667 5644 0 0 0 0
      0 0 0 0 0 0 0 0 0 5643 5667 5680 5689 5690 0 0 0 0 0 0 0 0 0 0 0 0 0 0 0 0 0 0 0 5643 0 0 0 0 0 0
      0 0 0 0 0 0 0 0 0 0 0 5679 5686 5666 5677 0 0 0 0 0 0 0 0 0 0 0 0 0 0 0 0 0 0 0 0 0 5645 5689 5646 0
      0 0 0 0 0 0 0 0 0 0 0 5643 5667 5644 0 0 5644 0 0 0 0 0 0 0 0 0 0 0 5644 0 0 5677 5677 0 5645 5689 5690 5686 5677 0
      0 0 0 0 0 0 0 0 0 0 0 0 0 0 0 0 0 0 0 0 0 0 0 0 0 0 0 0 0 5645 5689 5690 5688 5689 5690 5663 5664 5674 5688 5689
      0 0 0 0 0 0 0 0 0 0 0 0 0 0 0 0 0 0 0 0 0 0 0 0 0 5677 5677 5645 5689 5690 5674 5687 5665 5686 5665 5686 5675 5664 5663 5663
      0 0 0 0 0 0 0 0 0 0 0 0 0 0 0 0 0 0 0 0 0 0 0 0 5645 5690 5688 5690 5686 5687 5687 5686 5686 5686 5686 5687 5663 5665 5685 5666
      0 0 0 0 0 0 0 0 0 0 0 0 0 0 0 0 0 0 0 0 0 0 0 0 5679 5674 5664 5687 5675 5663 5676 5666 5668 5663 5676 5664 5666 5667 5667 5644
      0 0 0 0 0 0 0 0 0 0 0 0 0 0 0 0 0 0 0 0 0 0 0 5645 5690 5686 5663 5666 5667 5667 5668 5688 5690 5675 5676 5666 5644 0 0 0
      0 0 0 0 0 0 0 0 0 0 0 0 0 0 0 0 0 0 0 0 0 5645 5646 5679 5676 5675 5665 5677 0 0 5643 5668 5685 5664 5666 5644 0 0 0 0
      0 0 0 0 0 0 0 0 0 0 0 0 0 0 0 0 0 0 0 0 0 5679 5688 5690 5687 5665 5666 5644 0 0 0 5643 5668 5665 5677 0 0 0 0 0
      0 0 0 0 0 0 0 0 0 0 0 0 0 0 0 0 0 0 0 5645 5689 5690 5665 5675 5675 5674 5677 0 0 0 0 0 5679 5675 5677 0 0 0 0 0
      )
    )
    (tilemap
      (solid #t)
      (z-pos 0)
      (width 40)
      (height 40)
      (tiles
      1870 1874 7167 1874 1870 7050 1874 1874 1874 7041 1873 1873 1873 1874 1870 7167 1873 7041 7041 1873 1873 1874 1874 7041 7050 1873 1873 1870 1873 1873 7167 1873 1873 1873 7041 1873 1874 1874 1874 1873
      1870 1874 1870 1874 1873 7167 7050 7050 7167 1873 7167 7050 7041 1873 7167 7167 1873 1873 1873 7041 7167 1874 1874 1870 1873 7041 1873 1870 1874 7050 1874 1873 1874 1874 1874 1873 7050 1870 1873 1874
      1873 1874 1873 7050 1873 1873 1870 1873 1873 7041 1874 1874 1874 1873 7167 1870 1874 1874 7041 1874 7041 1874 7050 1874 7041 7050 1873 1873 1870 1874 1874 1874 1870 1873 1874 1874 1873 7167 1874 7041
      1873 7050 1873 7167 1874 1874 1874 1874 7041 1874 1873 1873 1874 1873 1870 1873 7167 1870 1874 1874 7041 7050 1873 1873 1874 7050 1874 7050 7050 1874 7050 7041 7050 1873 7050 1870 1873 1870 7167 1874
      1873 7041 1874 1873 7041 7050 7041 1870 1874 1870 7167 1870 1874 1873 1873 7050 1874 7050 1873 1874 1870 1873 7050 7041 1874 7167 7041 1874 1874 1874 1873 1874 7050 1874 1873 7041 1873 1874 1874 7050
      1874 7167 1874 1873 1873 1873 1873 1874 1870 7050 7050 7167 1874 1874 1874 1873 1873 1874 1873 1874 1874 1874 1874 7041 7050 1873 1874 1873 7050 7167 7041 1874 7167 1873 1873 7167 1874 1873 7050 1873
      1874 1873 7050 1874 1874 1874 7050 1873 7050 1874 1874 1870 1874 7050 1870 7050 7167 1874 1874 7167 7167 1873 1874 7167 1873 7167 1873 1873 1873 1874 7050 1874 1873 7041 1873 1873 1873 1873 1870 7041
      1874 1873 7167 7041 7041 7167 1873 7050 1874 1874 1874 1873 7167 1873 1874 1874 7041 1874 7050 1874 1874 1873 1874 1873 1874 7050 1873 1874 1874 1874 7041 1870 1870 7041 1874 7167 1873 1874 7050 7041
      1874 1873 1873 1873 1873 1874 7041 1874 1873 1873 1874 1874 1874 1869 1873 1873 7041 7050 1873 1870 1873 1873 7050 7050 1874 7050 1874 1873 1874 1874 1873 7050 1870 1873 1870 7041 1874 1873 1874 1874
      7050 1874 1874 1874 1874 7167 1874 1873 1873 1873 7041 1869 1869 1873 1870 1873 7167 1873 1874 7050 1873 1874 1873 1874 1873 7041 1870 7167 1874 7050 7041 1874 1873 1874 7167 1870 1873 1870 7167 7050
      7041 7050 1874 7050 1870 1874 1873 7167 1870 1873 1870 1869 1873 7167 7167 1873 1873 1874 1873 1870 7136 1877 1877 1879 1879 7137 1873 1873 7041 7050 1873 1874 7050 1874 1874 1874 7167 1873 1874 7050
      7167 7041 7167 1873 1874 1870 7041 7041 1870 1874 1873 1874 7167 7050 7167 1874 1870 1870 7136 3493 3494 0 0 0 0 3491 3492 7137 1870 1873 1870 1874 1873 1874 1874 1874 1870 1874 1873 7167
      7167 1870 1873 1874 1870 7050 1874 7050 1870 7050 1874 7167 1874 1874 1870 1870 7136 3493 3494 0 0 0 0 0 0 0 0 3497 7137 7041 1870 7167 7050 1873 7050 1873 1874 1874 1874 1874
      1870 1873 1874 7167 1874 1873 1873 1874 1873 1870 1873 7048 7049 1874 1870 7136 3498 0 0 0 0 0 0 0 0 0 0 0 3497 7137 1873 1874 1874 7048 7049 1870 1870 1874 7041 1873
      1873 1874 7041 1873 1873 1870 1873 1874 1873 1873 1874 7051 7052 1870 7136 3498 0 0 0 0 0 0 0 0 0 0 0 0 0 3497 7137 1873 7050 7051 7052 1873 1870 7041 1874 1874
      1873 1874 1873 7041 7050 7041 1873 7050 1874 7050 1873 1873 1873 1869 3496 0 0 0 0 0 0 0 0 0 0 0 0 0 0 0 3495 1873 1870 7050 1873 1874 1873 1874 1874 7041
      1873 7041 1874 1873 1873 1874 1873 7041 7167 1873 7167 1870 1874 7136 3500 0 0 0 0 0 0 0 0 0 0 0 0 0 0 0 3499 7137 1874 1874 1874 1873 7050 1873 7167 1874
      1873 1870 7048 7049 1870 1874 1870 1873 1873 7041 7050 7167 1869 1875 0 0 0 0 0 0 0 0 0 0 0 0 0 0 0 0 0 3491 3492 1877 7137 1873 1874 1874 1874 1874
      1874 1873 7051 7052 7050 1873 1873 1874 1869 1869 1869 1869 1869 3496 0 0 0 0 0 0 0 0 0 0 0 0 0 0 0 0 0 0 0 0 3491 3492 1877 1879 1877 1879
      1869 1869 1869 1874 7136 1879 1879 1879 7137 1869 1869 1869 7136 3500 0 0 0 0 0 0 0 0 0 0 0 0 0 0 0 0 0 0 0 0 0 0 0 0 0 0
      1874 1874 7136 3493 3494 0 0 0 3491 3492 1879 1879 3498 0 0 0 0 0 0 0 0 0 0 0 0 0 0 0 0 0 0 0 0 0 0 0 0 0 0 0
      1879 3493 3494 0 0 0 0 0 0 0 0 0 0 0 0 0 0 0 0 0 0 0 0 0 0 0 0 0 0 0 0 0 0 0 0 0 0 0 0 0
      0 0 0 0 0 0 0 0 0 0 0 0 0 0 0 0 0 0 0 0 0 0 0 0 0 0 0 0 0 0 0 0 0 0 0 0 0 0 0 0
      0 0 0 0 0 0 0 0 0 0 0 0 0 0 0 0 0 0 0 0 0 0 0 0 0 0 0 0 0 0 0 0 0 0 0 7143 7144 1862 1862 1862
      0 0 0 0 0 0 0 0 0 0 0 0 0 0 0 0 7143 7144 1861 1861 1861 1861 1862 1862 7145 7146 0 0 0 0 0 0 0 1890 1892 7147 7148 1865 1866 1865
      1861 1861 1861 1861 7145 7146 0 0 0 0 0 0 0 0 1890 1892 7147 7148 1865 1865 1865 1865 1866 1865 7149 7150 7151 7152 1862 1862 1861 7153 7154 1893 1896 1897 7050 7050 1873 1870
      1866 1866 1865 1865 7149 7150 7151 7152 1861 1861 1861 1861 7153 7154 1893 1896 1897 1873 1873 1873 1873 1873 7041 1874 1869 1898 7155 7156 1866 1865 1865 7157 7158 1897 1897 7050 7050 1873 1874 7041
      1874 1874 1869 1874 1874 1874 7155 7156 1866 1866 1865 1866 7157 7158 1897 1897 7167 7167 1874 7050 1874 1873 1873 1873 1874 7041 1870 7167 7050 1874 1873 7050 1873 1873 1873 7050 7041 1874 1873 7167
      1873 7167 7050 7167 1874 1873 1874 1869 1874 1869 1874 1873 7167 1870 1874 7050 1874 7050 7050 1873 1874 1874 7048 7049 1874 7041 1870 7167 7050 1874 1873 7050 1874 1874 1874 1874 7050 7041 1870 1873
      1873 1873 1873 7050 1873 1873 7050 1874 1874 1870 7167 1874 1874 1869 1874 1870 1873 7050 1870 1870 1874 7167 7051 7052 1873 1874 7050 1874 1874 1873 7041 1873 7041 1873 7041 1873 7041 1874 1873 1870
      1874 1874 7041 1874 1874 7050 1873 1873 1874 1874 7050 1874 1874 1874 1874 1874 7041 7167 1874 7041 7041 1874 1870 1873 1873 7041 1874 7041 1873 1873 1873 1873 1873 1873 1873 1873 1873 1874 1874 1870
      1874 7041 1874 1873 1874 1870 7167 1873 7167 1870 1874 1874 1873 1873 7041 1870 7050 1873 1873 7167 1873 1873 1873 7041 1873 1873 1873 1873 7167 1874 1870 1874 1870 1874 7167 1874 1870 1874 1874 1873
      1869 1874 1873 1873 1874 1874 1874 1873 1873 1874 1874 7041 7050 1873 1873 1874 7041 1874 7167 1870 7041 1873 1874 1874 1874 1870 1874 7050 7167 1870 1870 1870 1870 7167 7167 7167 1870 1873 1874 7167
      1869 1874 1874 1870 7041 7167 1874 1873 1874 1873 1874 1873 1874 1873 1874 1874 7167 1873 7167 1873 1874 1874 1873 1874 7041 7041 7050 1874 1873 7050 1873 7050 1873 1874 1873 1874 1873 1870 7167 7167
      1869 7041 1873 7167 1870 1874 1873 1873 1870 1870 1874 1874 1873 1873 1870 1873 1873 7050 7167 7041 1874 7050 7041 7050 1874 7167 1873 1874 1874 7050 7050 1874 1874 1874 1874 7050 7041 1873 1874 1873
      1869 1873 7167 7167 1873 7167 1870 1874 1874 7167 7050 1873 1873 1874 1874 1873 1874 1874 1873 1874 1874 1873 7050 1873 1873 1873 1870 7050 1873 7167 1874 7041 1873 7041 1874 1870 7050 1874 1874 1874
      1869 1874 1874 7041 1874 1874 7167 7050 1870 7050 1870 7050 1870 7167 1873 1874 1873 1874 1874 1873 1874 7041 7041 1874 1873 1874 7167 1873 1873 1873 1873 1873 1873 1873 1874 1874 7041 1873 7050 1874
      1873 7167 1873 7041 7050 1873 7041 1870 1874 7050 1873 1874 1873 1874 1873 1874 7050 1874 7167 1873 1870 1874 1873 1873 1874 1873 1873 7041 1874 7167 1874 7167 1874 1870 7050 1874 1873 1873 1873 1874
      1874 1874 1869 7041 1873 7050 7041 1873 1873 7050 7050 1873 1873 7167 1873 1870 1874 7050 1874 1873 1874 1874 1874 1873 7050 1873 1874 1874 7050 7041 7041 7167 7167 1873 1873 1874 7167 1874 1873 1873
      1874 7050 1874 7041 1874 1874 7041 7050 1870 7167 1873 1873 1874 1874 1873 1874 1874 1870 1873 1874 1873 7050 1873 1873 1873 1873 7167 1874 1873 7167 1874 1870 1874 1873 1873 7167 7167 1870 1873 7041
      )
    )
    (tilemap
      (solid #f)
      (z-pos -100)
      (width 40)
      (height 40)
      (tiles
      0 0 0 0 0 0 0 0 0 0 0 0 0 0 0 0 0 0 0 0 0 0 0 0 0 0 0 0 0 0 0 0 0 0 0 0 0 0 0 0
      0 0 0 0 0 0 0 0 0 0 0 0 0 0 0 0 0 0 0 0 0 0 0 0 0 0 0 0 0 0 0 0 0 0 0 0 0 0 0 0
      0 0 0 0 0 0 0 0 0 0 0 0 0 0 0 0 0 0 0 0 0 0 0 0 0 0 0 0 0 0 0 0 0 0 0 0 0 0 0 0
      0 0 0 0 0 0 0 0 0 0 0 0 0 0 0 0 0 0 0 0 0 0 0 0 0 0 0 0 0 0 0 0 0 0 0 0 0 0 0 0
      0 0 0 0 0 0 0 0 0 0 0 0 0 0 0 0 0 0 0 0 0 0 0 0 0 0 0 0 0 0 0 0 0 0 0 0 0 0 0 0
      0 0 0 0 0 0 0 0 0 0 0 0 0 0 0 0 0 0 0 0 0 0 0 0 0 0 0 0 0 0 0 0 0 0 0 0 0 0 0 0
      0 0 0 0 0 0 0 0 0 0 0 0 0 0 0 0 0 0 0 0 0 0 0 0 0 0 0 0 0 0 0 0 0 0 0 0 0 0 0 0
      0 0 0 0 0 0 0 0 0 0 0 0 0 0 0 0 0 0 0 0 0 0 0 0 0 0 0 0 0 0 0 0 0 0 0 0 0 0 0 0
      0 0 0 0 0 0 0 0 0 0 0 0 0 0 0 0 0 0 0 0 0 0 0 0 0 0 0 0 0 0 0 0 0 0 0 0 0 0 0 0
      0 0 0 0 0 0 0 0 0 0 0 0 0 0 0 0 0 0 0 0 0 0 0 0 0 0 0 0 0 0 0 0 0 0 0 0 0 0 0 0
      0 0 0 0 0 0 0 0 0 0 0 0 0 0 0 0 0 0 0 0 0 0 0 0 0 0 0 0 0 0 0 0 0 0 0 0 0 0 0 0
      0 0 0 0 0 0 0 0 0 0 0 0 0 0 0 0 0 0 0 0 0 0 0 0 0 0 0 0 0 0 0 0 0 0 0 0 0 0 0 0
      0 0 0 0 0 0 0 0 0 0 0 0 0 0 0 0 0 0 0 0 0 0 0 0 0 0 0 0 0 0 0 0 0 0 0 0 0 0 0 0
      0 0 0 0 0 0 0 0 0 0 0 0 0 0 0 0 0 0 0 0 0 0 0 0 0 0 0 0 0 0 0 0 0 0 0 0 0 0 0 0
      0 0 0 0 0 0 0 0 0 0 0 0 0 0 0 0 0 0 0 0 0 0 0 0 0 0 0 0 0 0 0 0 0 0 0 0 0 0 0 0
      0 0 0 0 0 0 0 0 0 0 0 0 0 0 0 0 0 0 0 0 0 0 0 0 0 0 0 0 0 0 0 0 0 0 0 0 0 0 0 0
      0 0 0 0 0 0 0 0 0 0 0 0 0 0 0 0 0 0 0 0 0 0 0 0 0 0 0 0 0 0 0 0 0 0 0 0 0 0 0 0
      0 0 0 0 0 0 0 0 0 0 0 0 0 0 0 0 0 0 0 0 0 0 0 0 0 0 0 0 0 0 0 0 0 0 0 1900 1901 1900 1901 1902
      0 0 0 0 0 0 0 0 0 0 0 0 0 0 0 0 0 0 0 0 0 0 0 0 0 0 0 0 0 0 0 0 0 0 0 1904 1905 1904 1905 1906
      0 0 0 0 1900 1901 1902 1903 1900 1901 1902 0 0 0 0 0 0 0 0 0 0 0 0 0 0 0 0 0 0 0 0 0 0 0 0 1900 1901 1902 1903 1900
      0 0 0 0 1904 1905 1906 1907 1904 0 0 0 0 0 0 0 0 0 0 0 0 0 0 0 0 0 0 0 0 0 0 0 0 0 0 1904 1905 1906 1907 1904
      0 0 0 0 1908 1909 1910 1911 1908 0 0 0 0 0 0 0 0 0 0 0 0 0 0 0 0 0 0 0 0 0 0 0 0 0 0 1908 1909 1910 1911 1908
      0 0 0 0 1912 1913 1914 1915 1912 1913 1914 0 0 0 0 0 0 0 0 0 0 0 0 0 0 0 0 0 0 0 0 0 0 0 0 1912 1913 1914 1915 1912
      0 0 0 0 1900 1901 1902 1903 1900 1901 1902 0 0 0 0 0 0 0 0 0 0 0 0 0 0 0 0 0 0 0 0 0 0 0 0 1900 1901 1902 1903 1900
      0 0 0 0 1904 1905 1906 1907 1904 1905 1906 0 0 0 0 0 0 0 0 0 0 0 0 0 0 0 0 0 0 0 0 0 0 0 0 1904 1905 1906 1907 1904
      0 0 0 0 1908 1909 1910 1911 1908 1909 0 0 0 0 0 0 0 0 0 0 0 0 0 0 0 0 0 0 0 0 0 0 0 0 0 0 0 0 0 0
      0 0 0 0 1912 1913 1914 1915 1912 1913 0 0 0 0 0 0 0 0 0 0 0 0 0 0 0 0 0 0 0 0 0 0 0 0 0 0 0 0 0 0
      0 0 0 0 1908 1909 1910 1911 1908 1909 0 0 0 0 0 0 0 0 0 0 0 0 0 0 0 0 0 0 0 0 0 0 0 0 0 0 0 0 0 0
      0 0 0 0 0 0 0 0 0 0 0 0 0 0 0 0 0 0 0 0 0 0 0 0 0 0 0 0 0 0 0 0 0 0 0 0 0 0 0 0
      0 0 0 0 0 0 0 0 0 0 0 0 0 0 0 0 0 0 0 0 0 0 0 0 0 0 0 0 0 0 0 0 0 0 0 0 0 0 0 0
      0 0 0 0 0 0 0 0 0 0 0 0 0 0 0 0 0 0 0 0 0 0 0 0 0 0 0 0 0 0 0 0 0 0 0 0 0 0 0 0
      0 0 0 0 0 0 0 0 0 0 0 0 0 0 0 0 0 0 0 0 0 0 0 0 0 0 0 0 0 0 0 0 0 0 0 0 0 0 0 0
      0 0 0 0 0 0 0 0 0 0 0 0 0 0 0 0 0 0 0 0 0 0 0 0 0 0 0 0 0 0 0 0 0 0 0 0 0 0 0 0
      0 0 0 0 0 0 0 0 0 0 0 0 0 0 0 0 0 0 0 0 0 0 0 0 0 0 0 0 0 0 0 0 0 0 0 0 0 0 0 0
      0 0 0 0 0 0 0 0 0 0 0 0 0 0 0 0 0 0 0 0 0 0 0 0 0 0 0 0 0 0 0 0 0 0 0 0 0 0 0 0
      0 0 0 0 0 0 0 0 0 0 0 0 0 0 0 0 0 0 0 0 0 0 0 0 0 0 0 0 0 0 0 0 0 0 0 0 0 0 0 0
      0 0 0 0 0 0 0 0 0 0 0 0 0 0 0 0 0 0 0 0 0 0 0 0 0 0 0 0 0 0 0 0 0 0 0 0 0 0 0 0
      0 0 0 0 0 0 0 0 0 0 0 0 0 0 0 0 0 0 0 0 0 0 0 0 0 0 0 0 0 0 0 0 0 0 0 0 0 0 0 0
      0 0 0 0 0 0 0 0 0 0 0 0 0 0 0 0 0 0 0 0 0 0 0 0 0 0 0 0 0 0 0 0 0 0 0 0 0 0 0 0
      0 0 0 0 0 0 0 0 0 0 0 0 0 0 0 0 0 0 0 0 0 0 0 0 0 0 0 0 0 0 0 0 0 0 0 0 0 0 0 0
      )
    )
    (torch
      (z-pos 0)
      (sprite "/images/objects/torch/torch4.sprite")
      (color 0.4 0.6 0.6)
      (x 64)
      (y 736)
    )
    (torch
      (z-pos 0)
      (sprite "/images/objects/torch/torch4.sprite")
      (color 0.4 0.6 0.6)
      (x 1216)
      (y 688)
    )
  )
)
