(supertux-level
  (version 3)
  (name (_ "Sound Test"))
  (author "FrostC, Tylerandari12")
  (license "CC-BY-SA 4.0 International")
  (icon "")
  (icon-locked "")
  (sector
    (name "main")
    (init-script "import(\"res/industrial/scripts/sound_test.nut\")
import(\"res/industrial/scripts/leave.nut\")

MusicPlayer(\"player\")
MusicSeeker(\"seekleft\", player, \"left\")
MusicSeeker(\"seekright\", player, \"right\")")
    (ambient-light
      (color 0.7 0.6 0.8)
    )
    (background
      (color 1 1 1)
      (speed 0)
      (fill #t)
      (image "/images/background/misc/vignette.png")
      (z-pos 300)
    )
    (background
      (color 0.2271324 0.0001997908 0.3220738)
      (speed 0.6)
      (image "/res/industrial/gfx-bg/outpost-5.png")
    )
    (background
      (color 0.09400704 0.01573719 0.1798152)
      (speed 0.1)
      (image "/res/industrial/gfx-bg/factory_inside_bg_furthest.png")
      (z-pos -309)
    )
    (bonusblock
      (name "player")
      (z-pos 51)
      (script "hit(player)")
      (count -1)
      (contents "script")
      (sprite "/res/industrial/gfx-misc/soundtest/pause.sprite")
      (x 480)
      (y 480)
    )
    (bonusblock
      (name "seekleft")
      (z-pos 51)
      (script "hit(seekleft)")
      (count -1)
      (contents "script")
      (sprite "/res/industrial/gfx-misc/soundtest/left.png")
      (x 384)
      (y 480)
    )
    (bonusblock
      (name "seekright")
      (z-pos 51)
      (script "hit(seekright)")
      (count -1)
      (contents "script")
      (sprite "/res/industrial/gfx-misc/soundtest/right.png")
      (x 576)
      (y 480)
    )
    (camera
      (name "Camera")
      (mode "normal")
    )
    (decal
      (z-pos 50)
      (sprite "/images/objects/letter/letter-small.sprite")
      (x 768)
      (y 512)
    )
    (gradient
      (blend "add")
      (top_color 0.3264733 0.411997 0.5 0)
      (bottom_color 0.9 0.5 1 0.4)
      (z-pos -288)
    )
    (infoblock
      (z-pos 50)
      (message (_ "Thanks for playing the industrial v2 demo!

More content will come in the future. If you have feedback, contact us through the Supertux Discord, Gamebanana, or the Freegamedev forums."))
      (x 208)
      (y 480)
    )
    (music
    )
    (scripttrigger
      (width 64)
      (height 114)
      (script "player.pause()
display_text_file(\"res/industrial/credits.stxt\")")
      (button #t)
      (x 752)
      (y 496)
    )
    (scripttrigger
      (width 16)
      (height 16)
      (script "shop_manager.leave()")
      (button #f)
      (x -16)
      (y 576)
    )
    (scripttrigger
      (name "leaveleft")
      (width 2)
      (height 34)
      (script "leave(\"left\", leaveleft)")
      (button #f)
      (x 0)
      (y 574)
    )
    (scripttrigger
      (name "leaveright")
      (width 2)
      (height 34)
      (script "leave(\"right\", leaveright)")
      (button #f)
      (x 990)
      (y 574)
    )
    (spawnpoint
      (name "main")
      (x 64)
      (y 512)
    )
    (text-area
      (width 64)
      (height 112)
      (x 752)
      (y 496)
      (once #f)
      (delay 4)
      (fade-delay 1)
      (anchor-point "top")
      (anchor-offset-x 0)
      (anchor-offset-y 80)
      (strings "[Press up to view credits]")
    )
    (tilemap
      (solid #f)
      (tint 0.6 0.4 0.7)
      (z-pos -100)
      (width 31)
      (height 27)
      (tiles
      0 0 0 0 0 0 0 0 0 0 0 0 0 0 0 0 0 0 0 0 0 0 0 0 0 0 0 0 0 0 0
      0 0 0 0 0 0 0 0 0 0 0 0 0 0 0 0 0 0 0 0 0 0 0 0 0 0 0 0 0 0 0
      0 0 0 0 0 0 0 0 0 0 0 0 0 0 0 0 0 0 0 0 0 0 0 0 0 0 0 0 0 0 0
      0 0 0 0 0 0 0 0 0 0 0 0 0 0 0 0 0 0 0 0 0 0 0 0 0 0 0 0 0 0 0
      0 0 0 0 0 0 0 0 0 0 0 0 0 0 0 0 0 0 0 0 0 0 0 0 0 0 0 0 0 0 0
      0 0 0 0 0 0 0 0 0 0 0 0 0 0 0 0 0 0 0 0 0 0 0 0 0 0 0 0 0 0 0
      0 0 0 0 0 0 0 0 0 0 0 0 0 0 0 0 0 0 0 0 0 0 0 0 0 0 0 0 0 0 0
      0 0 0 0 0 0 0 0 0 0 0 25279 0 25279 25280 25280 25280 25281 25281 25281 0 0 0 0 0 0 0 0 0 0 0
      0 0 0 23170 23170 23170 23170 0 0 0 0 23185 23186 25285 25286 25286 25286 25287 23185 23186 0 0 0 23170 23170 23170 23170 0 0 0 0
      0 0 0 23170 23170 23170 23170 0 0 0 0 23191 23192 25291 25292 25292 25292 25293 23191 23192 0 0 0 23170 23170 23170 23170 0 0 0 0
      0 0 0 23170 23170 23170 23170 0 0 0 23185 23186 23170 25150 25151 0 25148 25149 23170 23185 23186 0 0 23170 23170 23170 23170 0 0 0 0
      0 0 0 23170 23170 23170 23170 0 0 0 23191 23192 23194 0 0 0 0 0 23193 23191 23192 0 0 23170 23170 23170 23170 0 0 0 0
      0 0 0 23170 23170 23170 23170 0 0 0 25150 25151 0 0 0 0 0 0 0 25148 25149 0 0 23170 23170 23170 23170 0 0 0 0
      0 0 0 0 0 0 0 0 0 0 0 0 0 0 0 0 0 0 0 0 0 0 0 0 0 0 0 0 0 0 0
      0 0 23170 25153 23193 23170 23170 23170 0 0 0 0 0 0 0 0 0 0 0 0 0 0 0 23170 23170 23170 23194 25152 23170 0 0
      25279 25280 25281 25157 0 25279 25280 25281 0 0 0 0 0 0 0 0 0 0 0 0 0 0 0 25279 25280 25281 0 25156 25279 25280 25281
      25285 25286 25287 0 0 25285 25286 25287 0 0 0 0 0 0 0 0 0 0 0 0 0 0 0 25285 25286 25287 0 0 25285 25286 25287
      25291 25292 25293 0 0 25291 25292 25293 0 0 0 0 0 0 0 0 0 0 0 0 0 0 0 25291 25292 25293 0 0 25291 25292 25293
      0 0 0 0 0 23183 23184 23170 23188 0 1349 0 0 0 0 0 0 0 0 0 1349 0 23187 23170 23183 23184 0 0 0 0 0
      0 0 0 0 0 0 0 0 0 0 0 0 0 0 0 0 0 0 0 0 0 0 0 0 0 0 0 0 0 0 0
      0 0 0 0 0 0 0 0 0 0 0 0 0 0 0 0 0 0 0 0 0 0 0 0 0 0 0 0 0 0 0
      0 0 0 0 0 0 0 0 0 0 0 0 0 0 0 0 0 0 0 0 0 0 0 0 0 0 0 0 0 0 0
      23189 23189 23189 23189 23189 23183 23184 0 0 0 0 0 0 0 0 0 0 0 0 0 0 0 0 0 23183 23184 23189 23189 23189 23189 23189
      23190 23190 23190 23190 23190 23185 23186 23189 0 0 0 0 0 0 0 0 0 0 0 0 0 0 0 23189 23185 23186 23190 23190 23190 23190 23190
      0 0 0 25148 25149 23191 23192 23190 0 0 0 0 0 0 0 0 0 0 0 0 0 0 0 23190 23191 23192 25150 25151 0 0 0
      0 0 0 0 0 25152 23183 23184 0 0 0 0 0 0 0 0 0 0 0 0 0 0 0 23183 23184 25153 0 0 0 0 0
      0 0 0 0 0 25156 23183 23184 0 0 0 0 0 0 0 0 0 0 0 0 0 0 0 23183 23184 25157 0 0 0 0 0
      )
    )
    (tilemap
      (solid #f)
      (z-pos 300)
      (width 31)
      (height 27)
      (tiles
      4216 0 0 0 0 0 0 0 0 0 0 0 0 0 0 0 0 0 0 0 0 0 0 0 0 0 0 0 0 0 4214
      4216 0 0 0 0 0 0 0 0 0 0 0 0 0 0 0 0 0 0 0 0 0 0 0 0 0 0 0 0 0 4214
      4216 0 0 0 0 0 0 0 0 0 0 0 0 0 0 0 0 0 0 0 0 0 0 0 0 0 0 0 0 0 4214
      4216 0 0 0 0 0 0 0 0 0 0 0 0 0 0 0 0 0 0 0 0 0 0 0 0 0 0 0 0 0 4214
      4216 0 0 0 0 0 0 0 0 0 0 0 0 0 0 0 0 0 0 0 0 0 0 0 0 0 0 0 0 0 4214
      4216 0 0 0 0 0 0 0 0 0 0 0 0 0 0 0 0 0 0 0 0 0 0 0 0 0 0 0 0 0 4214
      4216 0 0 0 0 0 0 0 0 0 0 0 0 0 0 0 0 0 0 0 0 0 0 0 0 0 0 0 0 0 4214
      4216 0 0 0 0 0 0 0 0 0 0 0 0 0 0 0 0 0 0 0 0 0 0 0 0 0 0 0 0 0 4214
      4216 0 0 0 0 0 0 0 0 0 0 0 0 0 0 0 0 0 0 0 0 0 0 0 0 0 0 0 0 0 4214
      4216 0 0 0 0 0 0 0 0 0 0 0 0 0 0 0 0 0 0 0 0 0 0 0 0 0 0 0 0 0 4214
      4216 0 0 0 0 0 0 0 0 0 0 0 0 0 0 0 0 0 0 0 0 0 0 0 0 0 0 0 0 0 4214
      4216 0 0 0 0 0 0 0 0 0 0 0 0 0 0 0 0 0 0 0 0 0 0 0 0 0 0 0 0 0 4214
      4216 0 0 0 0 0 0 0 0 0 0 0 0 0 0 0 0 0 0 0 0 0 0 0 0 0 0 0 0 0 4214
      4216 0 0 0 0 0 0 0 0 0 0 0 0 0 0 0 0 0 0 0 0 0 0 0 0 0 0 0 0 0 4214
      4216 0 0 0 0 0 0 0 0 0 0 0 0 0 0 0 0 0 0 0 0 0 0 0 0 0 0 0 0 0 4214
      4216 0 0 0 0 0 0 0 0 0 0 0 0 0 0 0 0 0 0 0 0 0 0 0 0 0 0 0 0 0 4214
      4216 0 0 0 0 0 0 0 0 0 0 0 0 0 0 0 0 0 0 0 0 0 0 0 0 0 0 0 0 0 4214
      4216 0 0 0 0 0 0 0 0 0 0 0 0 0 0 0 0 0 0 0 0 0 0 0 0 0 0 0 0 0 4214
      4216 0 0 0 0 0 0 0 0 0 0 0 0 0 0 0 0 0 0 0 0 0 0 0 0 0 0 0 0 0 4214
      4216 0 0 0 0 0 0 0 0 0 0 0 0 0 0 0 0 0 0 0 0 0 0 0 0 0 0 0 0 0 4214
      4216 0 0 0 0 0 0 0 0 0 0 0 0 0 0 0 0 0 0 0 0 0 0 0 0 0 0 0 0 0 4214
      4216 0 0 0 0 0 0 0 0 0 0 0 0 0 0 0 0 0 0 0 0 0 0 0 0 0 0 0 0 0 4214
      4216 0 0 0 0 0 0 0 0 0 0 0 0 0 0 0 0 0 0 0 0 0 0 0 0 0 0 0 0 0 4214
      4216 0 0 0 0 0 0 0 0 0 0 0 0 0 0 0 0 0 0 0 0 0 0 0 0 0 0 0 0 0 4214
      4216 0 0 0 0 0 0 0 0 0 0 0 0 0 0 0 0 0 0 0 0 0 0 0 0 0 0 0 0 0 4214
      4216 0 0 0 0 0 0 0 0 0 0 0 0 0 0 0 0 0 0 0 0 0 0 0 0 0 0 0 0 0 4214
      4216 0 0 0 0 0 0 0 0 0 0 0 0 0 0 0 0 0 0 0 0 0 0 0 0 0 0 0 0 0 4214
      )
    )
    (tilemap
      (solid #t)
      (z-pos 0)
      (width 31)
      (height 27)
      (tiles
      0 0 0 0 0 0 0 0 0 0 0 0 0 0 0 0 0 0 0 0 0 0 0 0 0 0 0 0 0 0 0
      0 0 0 0 0 0 0 0 0 0 0 0 0 0 0 0 0 0 0 0 0 0 0 0 0 0 0 0 0 0 0
      0 0 0 0 0 0 0 0 0 0 0 0 0 0 0 0 0 0 0 0 0 0 0 0 0 0 0 0 0 0 0
      0 0 0 0 0 0 0 0 0 0 0 0 0 0 0 0 0 0 0 0 0 0 0 0 0 0 0 0 0 0 0
      0 0 0 0 0 0 0 0 0 0 25144 25145 25279 25280 25280 25280 25280 25280 25281 25146 25147 0 0 0 0 0 0 0 0 0 0
      0 0 0 0 0 0 0 25144 25145 23170 23185 23186 25285 25286 25286 25286 25286 25286 25287 23185 23186 23170 25146 25147 0 0 0 0 0 0 0
      0 0 25144 25145 23170 23183 23184 23170 23183 23184 23191 23192 25291 25292 25292 25292 25292 25292 25293 23191 23192 23183 23184 23170 23183 23184 23170 25146 25147 0 0
      23183 23184 23189 23183 23184 23170 23170 23183 23184 23170 23170 23183 23184 25150 25151 0 25148 25149 23183 23184 23170 23183 23184 23183 23184 23170 23170 23170 23189 23183 23184
      23183 23184 23190 23189 0 25148 25149 23170 23170 23185 23186 25150 25151 0 0 0 0 0 25148 25149 23185 23186 23170 23189 0 25148 25149 23170 23190 23183 23184
      25279 25281 23189 23190 0 23188 0 23189 23189 23191 23192 0 0 0 0 0 0 0 0 0 23191 23192 23189 23190 0 23188 0 23189 23189 25279 25281
      25285 25287 23190 23194 0 23170 0 23190 23190 23170 23194 0 0 0 0 0 0 0 0 0 23193 23170 23190 23194 0 23170 0 23190 23190 25285 25287
      25285 25287 23189 23188 23187 23194 0 23189 23185 23186 0 0 0 0 0 0 0 0 0 0 0 23185 23186 23188 23187 23194 0 23189 23189 25285 25287
      25291 25293 23190 23189 23170 23188 23187 23190 23191 23192 0 0 0 0 0 0 0 0 0 0 0 23191 23192 23170 23170 23188 23187 23190 23190 25291 25293
      23170 23183 23184 23190 23183 23184 23170 23170 23194 0 0 0 0 0 0 0 0 0 0 0 0 0 23193 23170 23170 23183 23184 23170 23183 23184 23170
      23183 23184 23194 0 0 0 0 0 0 0 0 0 0 0 0 0 0 0 0 0 0 0 0 0 0 0 0 0 23193 23183 23184
      0 0 0 0 0 0 0 0 0 0 0 0 0 0 0 0 0 0 0 0 0 0 0 0 0 0 0 0 0 0 0
      0 0 0 0 0 0 0 0 0 0 0 0 0 0 0 0 0 0 0 0 0 0 0 0 0 0 0 0 0 0 0
      0 0 0 0 0 0 0 0 0 0 0 0 0 0 0 0 0 0 0 0 0 0 0 0 0 0 0 0 0 0 0
      23170 23170 23170 25146 25147 0 0 0 0 0 0 0 0 0 0 0 0 0 0 0 0 0 0 0 0 0 25144 25145 23170 23170 23170
      23185 23186 23189 23189 23185 23186 23189 23183 23184 25279 25281 25316 25313 25314 25314 25314 25314 25314 25315 25316 25279 25281 23183 23184 23189 23185 23186 23189 23189 23185 23186
      23191 23192 23190 23190 23191 23192 23190 23170 23170 25285 25287 23170 0 0 0 0 0 0 0 23170 25285 25287 23170 23170 23190 23191 23192 23190 23190 23191 23192
      23183 23184 23170 23170 23170 23183 23184 23185 23186 25285 25287 23189 0 0 0 0 0 0 0 23189 25285 25287 23185 23186 23183 23184 23170 23170 23170 23183 23184
      0 0 0 0 0 25148 25149 23191 23192 25291 25293 23190 0 0 0 0 0 0 0 23190 25291 25293 23191 23192 25150 25151 0 0 0 0 0
      0 0 0 0 0 0 0 25152 25279 25281 23170 25153 0 0 0 0 0 0 0 25152 23170 25279 25281 25153 0 0 0 0 0 0 0
      0 0 0 0 0 0 0 25156 25285 25287 23189 25157 0 0 0 0 0 0 0 25156 23189 25285 25287 25157 0 0 0 0 0 0 0
      0 0 0 0 0 0 0 0 25285 25287 23190 0 0 0 0 0 0 0 0 0 23190 25285 25287 0 0 0 0 0 0 0 0
      0 0 0 0 0 0 0 0 25291 25293 23170 0 0 0 0 0 0 0 0 0 23170 25291 25293 0 0 0 0 0 0 0 0
      )
    )
    (torch
      (z-pos 0)
      (sprite "/res/industrial/gfx-obj/lantern/lantern-pole.sprite")
      (color 0.5 0.3 0.7)
      (x 320)
      (y 560)
    )
    (torch
      (z-pos 0)
      (sprite "/res/industrial/gfx-obj/lantern/lantern-pole.sprite")
      (color 0.5 0.3 0.7)
      (x 640)
      (y 560)
    )
  )
  (tileset "/res/industrial/gfx-tiles/tiles.strf")
)
